//1,2,3,4,5,6,7,8,9,10,11,12,13,14,15,16,17,18,19,20,21,22,23,24,25,26,27,28,29,30,31,32
0,0,0,0,0,0,0,0,0,0,0,0,0,0,0,0,0,0,0,0,0,0,0,0,0,0,0,0,0,0,0,0
0,0,0,0,0,0,0,0,0,0,0,0,0,0,0,0,0,0,0,0,0,0,0,0,0,0,0,0,0,0,0,0
0,0,0,0,0,0,0,0,0,0,0,0,0,0,0,0,0,0,0,0,0,0,0,0,0,0,0,0,0,0,0,0
0,0,0,0,0,0,0,0,0,0,0,0,0,0,0,0,0,0,0,0,0,0,0,0,0,0,0,0,0,0,0,0
0,0,0,0,0,0,0,0,0,0,0,0,0,0,0,0,0,0,0,0,0,0,0,0,0,0,0,0,0,0,0,0
0,0,0,0,0,0,0,0,0,0,0,0,0,0,0,0,0,0,0,0,0,0,0,0,0,0,0,0,0,0,0,0
0,0,0,0,230,0,0,0,0,0,260,0,0,260,0,0,0,0,0,0,0,0,0,0,0,0,0,0,0,0,0,0
0,0,0,0,800,0,0,800,0,0,800,0,0,800,0,0,0,0,0,0,0,0,0,0,0,0,0,0,0,0,0,0
0,0,0,0,801,801,0,802,802,0,803,803,0,804,804,0,0,0,0,0,0,0,0,0,0,0,0,0,0,0,0,0
0,0,0,0,801,800,0,802,800,0,803,800,0,804,800,0,0,0,0,0,0,0,0,0,0,0,0,0,0,0,0,0
0,0,800,800,800,800,800,800,800,800,800,800,800,800,800,800,0,0,0,0,0,0,0,0,0,0,0,0,0,0,0,0
0,0,0,0,0,0,0,0,0,0,0,0,0,0,0,0,0,0,0,0,0,0,0,0,0,0,0,0,0,0,0,0
0,0,0,0,0,0,0,0,0,0,0,0,0,0,0,0,0,0,0,0,0,0,0,0,0,0,0,0,0,0,0,0
0,305,202,0,0,0,307,0,0,0,306,0,0,0,308,0,0,0,0,0,0,0,0,0,0,0,0,0,0,0,0,0
0,800,800,800,800,800,800,800,800,800,800,800,800,800,800,800,800,0,0,0,0,0,0,0,0,0,0,0,0,0,0,0
0,0,0,0,0,0,0,0,800,0,210,0,210,0,800,0,0,0,0,0,0,0,304,0,0,800,0,0,0,0,0,0
0,0,0,0,0,0,0,0,0,0,800,800,800,0,0,0,0,0,0,0,0,800,800,800,800,800,0,0,0,0,0,0
0,0,0,0,0,0,0,0,0,0,0,0,0,0,0,0,0,0,0,0,0,0,0,0,0,800,0,0,0,0,0,0
0,800,800,800,0,0,0,0,0,0,0,0,0,0,0,800,800,0,0,0,0,0,0,0,0,800,800,0,0,0,0,0
0,1400,0,0,0,0,0,0,0,0,0,0,201,0,0,800,800,0,0,0,0,0,0,0,0,0,0,0,0,0,0,0
0,0,221,222,223,224,0,0,0,0,0,0,1801,300,0,800,800,0,0,301,0,0,0,0,302,0,0,0,0,303,0,0
800,800,800,800,800,800,800,800,800,800,800,800,800,800,800,800,800,800,800,800,800,800,800,800,800,800,800,800,800,800,800,800
800,800,800,800,800,800,800,800,800,800,800,800,800,800,800,800,800,800,800,800,800,800,800,800,800,800,800,800,800,800,800,800
800,800,800,800,800,800,800,800,800,800,800,800,800,800,800,800,800,800,800,800,800,800,800,800,800,800,800,800,800,800,800,800
